00400000
00111000
01111000
01000000
01111110
00000010
      2 
      2 
      2 
      2 
      2 
00000010
01110010
01010010
01111110
01000000
01111130
00000000