00000000
01111130
01001000
01111010
01111110
00000010
      2 
      2 
      2 
      2 
      2 
00000010
01111110
01000000
01111000
00111000
00400000